###.....................###.....................###
#.................................................#
#.................................................#
...................................................
...................................................
...................................................
........................###........................
........................###........................
........................###........................
...................................................
#...............###......T......###...............#
#...............###......U......###...............#
#...............###......U......###...............#
...................................................
........................###........................
........................###........................
........................###........................
...................................................
...................................................
...................................................
...................................................
#.................................................#
#.................................................#
###.....................###.....................###
