###################################################
##...............................................##
##...............................................##
##...............................................##
##...##.....................................##...##
##...####.................................####...##
##.....####.............................####.....##
##.......####.........................####.......##
##.........####.....................####.........##
##...........####.................####...........##
##.............####......X......####.............##
##...............####....X....####...............##
##.................####..X..####.................##
##...................##.....##...................##
##...............................................##
##...............................................##
##...............................................##
##...............................................##
##...............................................##
##...............................................##
##...............................................##
##...............................................##
##...............................................##
###################################################
