###################################################
##...............................................##
##...............................................##
##...............................................##
##...##.....................................##...##
##...####.................................####...##
##.....####.............................####.....##
##.......####.........................####.......##
##.........####.....................####.........##
##...........####.................####...........##
##.............####......T......####.............##
##...............####....U....####...............##
##.................####..U..####.................##
##...................##.....##...................##
##...............................................##
##...............................................##
##...............................................##
##...............................................##
##...............................................##
##...............................................##
##...............................................##
##...............................................##
##...............................................##
###################################################
